########0
000000000
000000@00
000D00000
0000=0000
000000000
000000000
0000F0000
000000000
