########0
000000000
000000000
000D00000
000000000
0000000F0