##########
#D00#0000#
#0#000#00#
#0##0#000#
#0000###0#
#0#0##=00#
###0000#0#
#000#00#=#
#@#0@00#F#
##########
