###########
#D00000000#
########00#
#@#000##00#
#000#00000#
#######==##
######0000#
######00F0#
###########
