#########
#0000000#
#000D000#
#0000000#
#000@000#
#=======#
#0000000#
#000F000#
#########
