########
D0000000
########
00000000
########
00000000
00000000
0000000F