0#######0######
000000000######
########0######
000D00000######
########0######
000000000######
000000000######
0000000F0######
0000000F0######
0000000F0######
0000000F0######
0000000F0######
0000000F0######
0000000F0######
0000000F0######